[
    {"x": 2, "y": 3},
    {"x": 2, "y": 5},
    {"x": 3, "y": 2},
    {"x": 3, "y": 6},
    {"x": 5, "y": 2},
    {"x": 5, "y": 6},
    {"x": 6, "y": 3},
    {"x": 6, "y": 5}
]
