[
    {"x": 2, "y": 2},
    {"x": 2, "y": 6},
    {"x": 3, "y": 3},
    {"x": 3, "y": 5},
    {"x": 5, "y": 3},
    {"x": 5, "y": 5},
    {"x": 6, "y": 2},
    {"x": 6, "y": 6}
]
